001100000000
000100001100
001100001100
000000000000
001000000100
001111111100